1 1 1 1 1 1 1 1 1 1 1 1 1 1 1 1
1 4 4 4 4 4 4 4 4 4 4 4 4 4 4 1
1 4 3 3 3 3 3 3 3 3 3 3 3 3 4 1
1 4 3 0 0 0 0 0 0 0 0 0 0 3 4 1
1 4 3 0 5 5 5 5 5 5 5 5 0 3 4 1
1 4 3 0 5 2 2 2 2 2 2 5 0 3 4 1
1 4 3 0 5 2 1 1 1 1 2 5 0 3 4 1
1 4 3 0 5 2 1 0 0 1 2 5 0 3 4 1
1 4 3 0 5 2 1 0 0 1 2 5 0 3 4 1
1 4 3 0 5 2 1 1 1 1 2 5 0 3 4 1
1 4 3 0 5 2 2 2 2 2 2 5 0 3 4 1
1 4 3 0 5 5 5 5 5 5 5 5 0 3 4 1
1 4 3 0 0 0 0 0 0 0 0 0 0 3 4 1
1 4 4 4 4 4 4 4 4 4 4 4 4 4 4 1
1 1 1 1 1 1 1 1 1 1 1 1 1 1 1 1
